######
#*#*##
#\.\##
#R#.##
#.#.##
#.#.##
#.#.##
#.#.##
#...##
##L.##
######
