#####
#\*\#
#. .#
#. .#
#. .#
##R##
##L##
