#####
#*#*#
#\.\#
#.#.#######
#.R......\#
##L########
 ###
