#####
# * #
# \ #
# R # 
##L##    
