###########
#.........#
#.#######.#
#.#.....#.#
#.#.###.#.#
#.#.#L#.#.#
#.#.#R..#.#
#.#.#####.#
#\#.......#
###########
