#####
#R L#
#* ##
#  \#
#\*##
####
